WE ./test-west.xpm
EA ./test-east.xpm
NO ./test-north.xpm
SO ./test-south.xpm       

C 119, 81, 53
F 110, 98, 89

111111111
100000001
100000001
100010001
100000001
1N0000001
111111111