WE ./redbrick.xpm
EA ./redbrick.xpm
NO ./redbrick.xpm
SO ./redbrick.xpm       

C 119, 81, 53
F 110, 98, 89

111111
1N0001
101001
110001
111111