WE ./redbrick.xpm
EA ./redbrick.xpm
NO ./redbrick.xpm
SO ./redbrick.xpm       

C 119, 81, 53
F 110, 98, 89

111111111111
100000000001
100010000001
100001000001
100100000001
100000000001
111111111111