WE ./test-west.xpm
EA ./test-east.xpm
NO ./test-north.xpm
SO ./test-south.xpm       

C 135, 206, 235
F 119, 81, 53

                           
                                  
                                    
                            
                     11111
                     1E001
                     10001
                     10001
                     11111