NO ./assets/textures/test/north.xpm
SO ./assets/textures/test/south.xpm
WE ./assets/textures/test/west.xpm
EA ./assets/textures/test/east.xpm

F 20, 20, 20
C 200, 200, 200

1111111111111111111
111
1111S1111111111   1
111000000000001   1
111000000100001   1
111000000000001   1
111000000000001   1
111000000000001   1
111100000000001   1
111000000000001   1
111000000000001   1
111000000000001   1
111000000000001   1
111000000000001   1
111111111111111   1
11                1
1111111111111111111