NO ./assets/textures/test/north.xpm
SO ./assets/textures/test/south.xpm
WE ./assets/textures/test/west.xpm
EA ./assets/textures/test/east.xpm

F 20, 20, 20
C 200, 200, 200

11111111111111111
				1
1111111111111   1
10S0000000001   1
1000000100001   1
1000000000001   1
1000000000001   1
1000000000001   1
1100000000001   1
1000000000001   1
1000000000001   1
1000000000001   1	
1000000000001   1
1000000000001   1
1111111111111   1
                1
11111111111111111











1