NO ./assets/textures/wolfenstein/grey_stone.xpm
SO ./assets/textures/wolfenstein/purple_stone.xpm
WE ./assets/textures/wolfenstein/red_brick.xpm
EA ./assets/textures/wolfenstein/wood.xpm

F 18,53,25
C 153,204,255

111111  11111	
111111  11111	
1    1111  11	
1           1	
1111111111111	
110S000000001	
1111111111111	
1           1	
1111111111111	