NO ./assets/textures/wolfenstein/grey_stone.xpm
SO ./assets/textures/wolfenstein/purple_stone.xpm
WE ./assets/textures/wolfenstein/red_brick.xpm
EA ./assets/textures/wolfenstein/wood.xpm

F 18,53,25
C 153,204,255

11111  11111
11111  11111
    1111  11
           1
111111111111
10S000000001
111111111111
           1
111111111111
