WE ./tex/east.xpm
EA ./tex/east.xpm
NO ./tex/east.xpm
SO ./tex/east.xpm

C 136, 219, 223
F 110, 98, 89

    111111111111111111111111        
1111111             111111
1111111 N         111111
1111111          11111111 
1111111            11111    
111111111111111111111111