WE    ./assets/textures/west.xpm
SO      ./assets/textures/south.xpm
EA ./assets/textures/east.xpm
NO ./assets/textures/north.xpm

C 136, 219, 223
F 110, 98, 89

11111111
11000011
100000E1
11000011
11000011
11000011
11000011
11000011
11111111