WE    ./assets/tex/west.xpm
SO      ./assets/tex/south.xpm


EA ./assets/tex/east.xpm

NO ./assets/tex/north.xpm

C 136, 219, 223
F 110, 98, 89


             111111111111111
            100000000000001
            100000000000001
            100000000000001  
            1N0010000000001  
             111011111111111 
             111111111111111


