WE ./assets/textures/test/japan-wall-shoji-top.xpm
EA ./assets/textures/test/japan-wall-shoji-top-2.xpm
NO ./assets/textures/test/japan-wall-shoji-wall-2.xpm
SO ./assets/textures/test/japan-wall-shoji-wall.xpm

C 136, 219, 223
F 110, 98, 89

11111111111111111111111111111111111111111111111111111
10000011100000011000000111000000000000000000000000001
11110111101111011011110111111111111111111011111111101
10000111100000011000000111100000000000000000000000001
10110111110111011011110111101111111111111111101111101
1111011111011101101111011110111111111       101   101
1000000000000000000000000000000000011       101   1011
11011111111101111111111111111111110111111111101   1001
11000000000000000000000000000000000000000000001   1101
11111111111111111111111111011111111011111111101    101
                         101      101       101    101
                         101      101       101    101
                         101      101       101    101
                         101      101       101    101
                         101      101       101    101
                         1011111111011111111101    101
                         1000000000000000000001    101
                         1111110111111110111111    101
                              101      101         101
                              101      101         101
                              101      101         101
                              101      101         101
                              101      101         101
                              1011111111011111111111011111
                              1000000000000000000000000001
                              111111111111111111111100W001
                                                   1000001
                                                   1111111 