NO ./assets/textures/test/test-north.xpm
SO ./assets/textures/test/test-south.xpm
WE ./assets/textures/test/test-west.xpm
EA ./assets/textures/test/test-east.xpm
F 220, 100, 0
C 225, 30, 0

111111111111
100000000011
100000000001
111111111111
10S000000001
111111111111
110000000001
111111111111