WE ./assets/tex/test-west.xpm
EA ./assets/tex/test-east.xpm
NO ./assets/tex/test-north.xpm
SO ./assets/tex/test-south.xpm       

C 135, 206, 235
F 119, 81, 53

                           
                                  
                                    
                            
                     11111
                     1N001
                     10001
                     10001
                     11111