WE ./assets/tex/test-west.xpm
EA ./assets/tex/test-east.xpm
NO ./assets/tex/test-north.xpm
SO ./assets/tex/test-south.xpm       

C 135, 206, 235
F 119, 81, 53


       

 
 1111111111
 1113333311
 1120000041
 112N000041
 1120000041
 1120000041
 1120000041      
 1120000041 
 1120000041
 1120000041  
 1120000041
 1120000041
 1120000041
 1120000041
 1120000041
 1120000041    
 1120000041
 1120000041
 1120000041
 1125555511
 1111111111