WE ./assets/tex/test-west.xpm
EA ./assets/tex/test-east.xpm
NO ./assets/tex/test-north.xpm
SO ./assets/tex/test-south.xpm       

C 135, 206, 235
F 119, 81, 53


       

 
 1111111111
 1111111111
 1110000011
 111N000011
 1110000011
 1110000011
 1110000011      
 1110000011 
 1110000011
 1110000011  
 1110000011
 1110000011
 1110000011
 1110000011
 1110000011
 1110000011    
 1110000011
 1110000011
 1110000011
 1111111111
 1111111111