WE ./assets/textures/test/test-west.xpm
EA ./assets/textures/test/test-east.xpm
NO ./assets/textures/test/test-north.xpm
SO ./assets/textures/test/test-south.xpm       

C 135, 206, 235
F 119, 81, 53

                                
       
                                  
                                    
                            
         11111           
         1S001           
  1      10001        1   
         10001           
         11111           
         



         